###########################
#o....#.............#....o#
#.##.#.#.#########.#.#.##.#
#....#.#.....G.....#.#....#
####.#.#####.#.#####.#.####
#...........#.#...........#
#.#####.###.#.#.###.#####.#
#.....#...#..G..#...#.....#
#####.###.#######.###.#####
#.............G...........#
#.#####.#.#######.#.#####.#
#o......#....C....#......o#
#.#########.#.###########.#
#.........................#
###########################
