#############################################
#o.........................................o#
#..#.##..#.##.##.##.##.##..#.##..#.##.##.##.#
#..#.......##.##.##.##.##..#.##..#.##.##.##.#
#..#.##..#.##.##.##.##.##..#.##..#.##.##.##.#
#...........................................#
#.##.##.##.##.##..#.##.##.##.##.##.##.##.##.#
#.##.##.##.##.....#.......##.##.##.##.##.##.#
#.##.##.##.##.##..#.##G##.##.##.##.##.##.##.#
#..........................G................#
..##.##.##.##.##.G#..#.##.##..#.##..#..#.##..
#.##....##.##.##..#..#.##.##....##..#..#.##.#
#.##.##.##.##.##..#..#G##.##..#.##..#..#.##.#
#...........................................#
#.##.##.##.##.##.##.##.##.##.##.##.##.##..#.#
#.##.##.##.##.##.##.##.##....##....##.....#.#
#.##.##.##.##.##.##.##.##.##.##.##.##.##..#.#
#...........................................#
#.##.##.##.##.##.##.##C##.##.##.##.##.##.##.#
#o##.##.##.##.##.##.##.##.##.##.##.##.##.##o#
#############################################
