###########################################################
#.o.....................................................o.#
#.........................................................#
#........#.......................................#........#
#....######################.....######################....#
#........#.......................................#........#
#........#..........#.................#..........#........#
#........#..........#.................#..........#........#
#........#....#############.....#############....#........#
#........#..........#.................#..........#........#
#............................G............................#
#..........................G...G..........................#
#.........................................................#
#........#..........#.................#..........#........#
#........#....#############.....#############....#........#
#........#..........#.................#..........#........#
#........#..........#.................#..........#........#
#........#...................C...................#........#
#....######################.....######################....#
#........#.......................................#........#
#.........................................................#
#.o.....................................................o.#
###########################################################
